row,0,1,2,3,4,5,6,7,8,9
0,s,f,0,0,0,0,0,f,0,0
1,0,0,0,f,0,0,0,0,0,f
2,0,0,0,0,0,0,0,0,0,0
3,0,0,0,0,0,f,0,0,0,0
4,0,0,0,0,0,0,0,0,0,0
5,0,0,0,0,0,0,0,0,0,f
6,0,f,0,0,0,0,0,0,0,0
7,0,f,0,f,0,0,0,0,0,0
8,0,0,0,0,0,0,0,0,0,0
9,0,0,0,0,0,0,0,f,0,g
