row,0,1,2,3,4,5,6,7,8,9,10,11
0,#,#,#,#,#,#,#,#,#,#,#,#
1,#,s,f,0,0,0,0,0,f,0,0,#
2,#,0,0,0,f,0,0,0,0,0,f,#
3,#,0,0,0,0,0,0,0,0,0,0,#
4,#,0,0,0,0,0,f,0,0,0,0,#
5,#,0,0,0,0,0,0,0,0,0,0,#
6,#,0,0,0,0,0,0,0,0,0,f,#
7,#,0,f,0,0,0,0,0,0,0,0,#
8,#,0,f,0,f,0,0,0,0,0,0,#
9,#,0,0,0,0,0,0,0,0,0,0,#
10,#,0,0,0,0,0,0,0,f,0,g,#
11,#,#,#,#,#,#,#,#,#,#,#,#
